1 1 1 1 1 1 1 1 1 1 1
1 3 0 0 0 P 0 0 8 7 6 
1 0 0 0 0 0 0 0 0 0 1
1 0 0 0 0 5 0 0 0 0 1
1 2 0 0 0 0 0 0 0 0 1
1 2 0 0 0 0 0 0 0 0 1
1 2 0 0 0 0 0 0 0 0 1
1 1 1 1 1 1 1 1 1 1 1