1 1 1 1 1 1 1
1 3 0 0 0 4 1
1 P 0 0 0 0 1
1 0 0 5 0 0 1
1 2 0 0 0 4 1
1 1 1 1 1 1 1